PikaBot	KEYWORD1

pitchToFreq	KEYWORD2
calibrateMotors	KEYWORD2
detectLine	KEYWORD2
isPressed	KEYWORD2
lineFollow	KEYWORD2
move	KEYWORD2
moveBackward	KEYWORD2
moveForward	KEYWORD2
playTone	KEYWORD2
playToneMs	KEYWORD2
setTempo	KEYWORD2
stop	KEYWORD2
turnLeft	KEYWORD2
turnRight	KEYWORD2
ultrasonicDistance	KEYWORD2

WHOLE	LITERAL1
HALF	LITERAL1
QUARTER	LITERAL1
EIGHTH	LITERAL1
SIXTEENTH	LITERAL1
DOUBLE	LITERAL1
BREVE	LITERAL1
LEFTIR	LITERAL1
RIGHTIR	LITERAL1